111111111111
1P0C0Z0C0011
10000C00E011
1000Z0001011
111111111111
