1111111111
1P00000001
10Z00C0001
10Z00E0011
1111111111
